1111111
1000001
10PEC01
1000001
1111111