111111111111111111111111
1P000000000000C00C000001
100000E00000C000000C0001
111111111111111111111111