111111111111111
10PEC0000001001
100001010001001
100100010000001
111111111111111