1111111
1M000M1
10PEC01
10000M1
1111111